

           ##########################################################
         ###                                                        #
       ###                                                          #
      ##                                                            #
     ##                                                             #
    ##                                                              #
    ##   ###########################################-----############
    #    #           #s#     #      #       *                    ***#
    #    #           # #     #              *                    ***#
    #    #           # #     #              *        ***            #
    #    #     Q     # #     #      #       *        ***            #
    #    #           # #     #      #       *        ***            #
    #    #           # #     #      #       *                    ***#
    #    #           # #     #      #       *                    ***#
    #    #           # #     #      #       *                       #
    #    ########## ##+#     #      |       *                       #
    #    #                          |       *        ***            #
    #    #                          |       *        ***         ***#
    #    #                          |       *        ***         ***#
    #    #                          |       *                       #
    #    #                          |       *                       #
    #    #                          |      *                        #
    #    #                          #******                         #
    #    #                          #                   **       ***#
    #    #                          +                   **       ***#
    #    #                          #                   **          #
    #    ###-----##-----########################++###################
    ##                                                              #
    ##                                                              #
     ##                                                             #
      ##                                                            #
       ###                                       p                  #
         ###                                                        #
           ##########################################################
