

            ##########################################################################
          ##                                                                         #
        ##                                                                           #
       #                                                                             #
      #                                                                              #
     #                                                                               #
	 #             ################################################################### 
    #             #          # <#     #                                              #     
	#            #           #  #     #                                              #
    #            ##############+######################################################     
	#            #                       #                                           #      
    #            #                       #                                           #     
	#            #################       #                                           #          
    #            #                       #                                           #             
	#            #                       #                                           #         
    #            #################       #                                         ###     
	#            #                                                                 +P#    
    #            #                                                                 +P# 
	#            #################                                                 +P# 
    #            #                                                                 +P#   
	#            #                       #                                         ###     
    #            #################       #                                           #      
	#            #                       #                                           #                        
    #            #                       #                                           #                   
	#            #                       #                                           #                    
    #            #                       #                                           #                    
	#            #####################################################################
     #                                                                               #
	 #                                                                               #           
      #                                                                              #
       #                                                                             #
        ##                                                                           #
          ##                                                                         #
            ##########################################################################
